18 18 18 18 18 18 18 18 18 18 18 18 24 01 01 23 18 18 18 18 18 18 18 18 18 18 18 18
18 18 18 18 18 18 18 18 18 18 18 18 24 01 01 23 18 18 18 18 18 18 18 18 18 18 18 18
18 18 18 18 18 18 18 18 18 18 18 18 24 01 01 23 18 18 18 18 18 18 18 18 18 18 18 18
18 18 18 18 18 18 18 19 18 18 18 18 24 01 01 23 18 18 18 18 18 18 18 18 18 18 18 18
18 18 18 18 18 18 18 19 18 18 18 18 24 01 01 23 19 18 19 18 18 18 18 18 18 18 18 18
18 18 18 18 18 18 18 18 18 18 19 18 24 01 01 23 18 18 18 18 19 18 18 18 18 18 18 18
18 18 18 18 18 18 18 18 18 19 18 18 24 01 16 23 18 18 18 18 19 18 18 18 18 18 18 18
18 18 18 18 18 18 18 18 28 26 26 26 27 01 01 25 26 26 26 29 18 18 18 19 18 18 18 18
18 18 18 18 19 19 18 18 24 01 01 01 01 01 01 01 01 01 01 23 18 19 18 18 18 18 18 18
18 18 18 18 19 18 18 18 24 02 01 01 01 01 01 01 01 01 01 23 19 18 18 18 18 18 18 18
18 18 18 18 18 18 18 18 24 01 01 01 01 01 01 01 01 01 01 23 18 18 18 18 19 18 18 18
18 18 19 18 18 18 18 18 24 01 01 01 01 01 01 02 01 01 01 23 18 18 18 18 18 18 18 18
18 18 18 18 19 19 18 18 24 01 01 01 01 01 01 01 01 01 01 23 18 19 19 18 18 18 18 18
18 18 18 18 18 18 18 18 24 01 01 01 01 01 01 01 01 01 01 23 18 18 19 18 18 18 18 18
18 18 18 18 18 18 19 18 24 01 01 01 01 01 01 01 01 01 01 23 18 18 18 18 19 18 18 18
18 18 18 18 18 18 18 18 24 01 01 01 01 01 01 01 01 01 01 23 19 18 19 18 18 18 18 18
18 18 18 18 18 19 18 18 24 01 01 01 01 01 01 01 01 01 01 23 19 18 18 18 18 18 18 18
18 18 18 18 18 18 19 18 24 01 01 01 01 01 01 01 01 01 01 23 18 18 18 18 18 18 18 18
18 18 18 18 18 18 18 18 30 21 21 21 22 16 16 20 21 21 21 31 18 19 18 18 18 18 18 18
18 18 18 18 18 18 18 18 18 19 18 18 24 01 01 23 18 19 18 18 19 18 18 18 18 18 18 18
18 18 18 18 18 18 18 18 18 18 18 19 24 01 01 23 18 18 19 18 18 18 18 18 18 18 18 18
18 18 18 18 18 18 18 19 18 18 18 18 24 01 01 23 19 19 18 18 18 18 18 18 18 18 18 18
18 18 18 18 18 18 18 18 18 18 18 18 24 01 01 23 19 18 18 18 18 18 18 18 18 18 18 18
18 18 18 18 18 18 18 18 18 18 18 18 24 01 01 23 18 18 18 18 18 18 18 18 18 18 18 18
18 18 18 18 18 18 18 18 18 18 18 18 24 01 01 23 18 18 18 18 18 18 18 18 18 18 18 18